XXXXXXXXXXXXXXXXXXXXXXXXXXXXXXXXXXXXXXXXXXXXXXXXXXXXXXXXXXXXXX
Xo       X                            X       X              X
X XXXXXX X XXXXXXXXXXXXXXXXXXXXXXXXXX X XXXXX X XXXXXXXXXXXX X
X X         XXXXXXX                     XXXXX        X      oX
X XXXXXXX X       X    XXXXX XXXX XXX   XXXXX XXXXXX X XXXXX X
X       XXX XXXX  XXXX            XXX***XXX                  X
XXXXXXX XXX XXXX        X XXXX XX X*******X  XXXXXXXXXXXX XXXX
X              XXXXXXX  X         X*******X  X          X    X
XXXXXXXXXXXXXX          XXXXXXXXX XXXXXXXXX XXXXX XX X XX XXXX
X              XXXXX XX                              X XX   oX
X XXXXX XXXXXXXXXXXX XXXXXXXX XXXXXXX X XXXXXXXXXXXXXX XX XX X
Xo                  P  X               X                     X
XXXXXXXXXXXXXXXXXXXXXXXXXXXXXXXXXXXXXXXXXXXXXXXXXXXXXXXXXXXXXX